#########\n
#S   #  #\n
# ### # #\n
# #     #\n
# # ### #\n
#   #   #\n
### ### #\n
#       #\n
# ##### #\n
#      ##\n
