############## \n
#S        #E # \n
# #########  # \n
# #        # # \n
# # X##### # # \n
# #      # # # \n
# ###### # # # \n
#        #     \n
###############\n