        #    \n
  #########E#\n
# #         #\n
# ##### #####\n
        #### \n
#######      \n
### #### ####\n
###          \n
###          \n