#########\n
####E####\n
#### ####\n
#   S   #\n
#### ####\n
#### ####\n
#########\n