#########\n
#### ####\n
#   S   #\n
#### ## #\n
##   ####\n
## ###E##\n
##     ##\n