#########\n
##     E#\n
## ######\n
#     # #\n
##### # #\n
E   # # #\n
### # # #\n
#   #   #\n
### ## ##\n
S        \n