####################\n
#S        #       S#\n
#########  #  ######\n
#  #  #  # #  #    #\n
# # # ## # # # #####\n
 ## # ## # # # #    \n
 ## # ## # # # #####\n
 ## #    # # # # ###\n
 ## ##### # # # # ##\n
 ##       # # # # ##\n
 ########## # # # ##\n
  #         # # # ##\n
# ########### # # ##\n
#E            #   ##\n
####################\n
