#########
#S   #  #
# ### # #
# #     #
# # ### #
#   #   #
### ### #
#       #
# ##### #
#      ##
