############## 
#S        #E # 
# #########  # 
# #        # # 
# # X##### # # 
# #      # # # 
# ###### # # # 
#        #     
###############