        #    
  #########E#
# #         #
# ##### #####
        #### 
#######      
### #### ####
###          
###          