####################
#S        #        #
#########  #  ######
#  #  #  # #  #    #
# # # ## # # # #####
# # # ## # # # #    
# # # ## # # # #####
# # #    # # # # ## 
# # #####   # # # # 
# #       # # # # # 
# # ####### # # # # 
# #         # # # # 
# # ######### ####
#E            #   #
####################