#########
#### ####
#   S   #
#### ## #
##   ####
## ###E##
##     ##