####################
#S        #       S#
#########  #  ######
#  #  #  # #  #    #
# # # ## # # # #####
 ## # ## # # # #    
 ## # ## # # # #####
 ## #    # # # # ###
 ## ##### # # # # ##
 ##       # # # # ##
 ########## # # # ##
  #         # # # ##
# ########### # # ##
#E            #   ##
####################
