#########
##     E#
## ######
#     # #
##### # #
E   # # #
### # # #
#   #   #
### ## ##
S        